

+ + 0 + + 
+ 0 > . 0 
0 0 + . . 
0 0 + + . 
+ 0 0 0 x 
